#######
#.$ . #
#     #
#$    #
# $   #
#. $.@#
#######
