######
#.   #
#    #
#$ @ #
#    #
######
