######
#.$ .#
##   #
# $@ #
#    #
######
