########
#..    #
#..#   #
#  #@$ #
#   $$ #
#   $  #
#      #
########
