#######
#.$ . #
#     #
#$$@  #
#     #
#.    #
#######
